-----------------------1----------------------------------------------------------1---------------------------------------------------------------------------------------------------------------------
--1----------1----------------------------------------------1--------%-----F@----------------------------------------------------%--%--------------------------------------------------------%----------
----------------|----------B------------------------------------------------X---B---1--------------------------------------------------G2----------------------------------------o----o-----o-----------
------------------------------2-------------------------------1-------------%---1--------%-------------------------------------------------------------------------------------------%---%------o-------
-----------------%b-|---|--|-|--------o--------------------------B-EM-2-@--Q-----%-------|-1-M----------------------------------------@-F--C-----------------------------------o------------tF@---T--1--
---------------oo---%%%-------%------------------------------o--2------%--%-%------%---%-%-%----------------------------------------------%-------------------------o------%----S-%-------%---------%---
-----1----o-----|-t||||QtbbUtUtG--------------------o---11------o2-1CQXKt||Q2121LCGBBC21btT1U|b@-------------o------------------@---@BK@@@KQ2F2-o--o------------M1--11----1-----t1EKt||||bQFF1--tEt|F2B@
1---------------S1CL@2--1111111-----------------2---------------@------1111-----E-1------1--122%----------------1----------o----1----------1-----o--------------2---------------G-----1111------o122111-
-M-----------o1B1---1-------------------------------------------1--------1--------------------B---------------------------------------------------------------------------------1---------------F%------
--------------1Q1--------------------------------------------21----------------------1---1---B1-------------------------------------------------------------------------------------------------1----1--
---------------@-1-----------1------------------1------------1-----------2------1--------1---1-------------------------------------------------------------------------o----------------------------11--
1-2----------1--@2------------------------------#%#%-----o------1-----1------F|%t1X-1-----------%11%%%1----o----@%-%-----o------t2Q------------%%##--------%2-1%1o-------------%1--o----U|t-2ot%@-------
----------1L%-%%1----------------------------%--|||o%------------------------||%--%%%-----------QX||||%-%%%%----|%t-------------#%#-----------@|t||1------%bt%---------%%%----1B---------T21-2G%--------
%---------2|C|||1--------------------------%#%#%||o%%-----------1----1------2||#12|||t%----|b---UXo||t#|||||%---#%#-%-----------|||-----------1t|||%%--1%%#%XtE%------||||%---1E2---1@--GtF-Q||%L------%
X-XXXX-XXXXXXXXXXXX-XXX-XXXXXXXXXXXXXXXXXXXXXXXXXXXX--XXX-XX-XXXXXXXXX-XXXXXXXXXXXXXXXXX-XXXXXXXX-XXXXXXXX-XXXXXX-XXXXXXX-XXXXXXXXXXXX-XXXX-XXXXXXXXXXXX-XXXXXXXXXX---XXXXXXXXXXXXXXXXXXXXXXXXXXXXXXX-FX
X-XXXX-XXXXXXXXXXXX-XXX-XXXXXXXXXXXXXXXXXXXXXXXXXXXX--XXX-XX-XXXXXXXXX-XXXXXXXXXXXXXXXXX-XXXXXXXX-XXXXXXXX-XXXXXX-XXXXXXX-XXXXXXXXXXXX-XXXX-XXXXXXXXXXXX-XXXXXXXXXX---XXXXXXXXXXXXXXXXXXXXXXXXXXXXXXX--X