--------------------------------------------------------------------------------------------------------------------------------------------------------------------------------------------------------
----------------------------------------1---------------------------------------------------%--------------------------------------------------------%--------------------------------------------------
-----------------------------------B------------------------------------------------o------------U--o------bo---------------------------------------t--M-F----@-----------------------------------------
--------------1-----------------C--1--1-----------------------------------------o---------------K---%-------------------------------------------X-------------------------------------------------------
-----@--1----1-----------------------------------------------------o-------------o|--Q--o-1-ot----o----S-----T--o--o-------------------------------t---T--t-----o---------------------------------------
1----oo-%-%---------------------1-o---1--11-----------------------------------------112------1----------------%---------------------------------@%%-%-----------o------------------o--------------------
Q-BEBE@1BXLB11-----o------------2---1-1-1212@2----------------------------------|QBUXLbtT1211@1-TE21QG@BFQB2EG11--------------------------------T-1BbXbFooB-@21---------------------------------o-------
@--------1--------o-------------1----11----o--------------------o---------------t----111--------11------o------o------------------------------o-C----11--1-----------------o------o---------o-----------
-M----------------------------------------------------------o-------------------1--------o------1----------------o------------------------------1---------------------------------o---------------------
-----------------------------------------------------------------------o----------%--------------o----------o----------------------------2----------------o---------------------------------o-----------
-------------------------------1-----1-------1----------------------------------1B||@C-----o-11------------------------------------------L%------------------1-----------------------------o------------
1-S----------o---------o------B1-----------------------o------------o---@-------1-||%------o----1-------------1--------------------------B11------------------1-1-----------------2-----%%-%#%--%1%%%%--
1-%---------------------%%%%#%%%-------------------------------------%-%%%%%%%--1-|t%------------------------%%%---------------------------%%%---------------%-%---------%--------------||||||---%||||-%
%-|--------1#%%%--------||||||||%----1%%%%----1%-------%%%%-%-%%-1%%%-GQ|||||---%----------------------------|||-----%#%--%%#%#%---%%%%%%--t|o%---------------||-------1K##-#%-%-------%S|Lt|G%%CE|||XKo
X-XXXXXXXXXXXXXXXXXXXXXXXXXXXXXXXXXXXXXXXXXXXXX-XXXXXXXXXXX-XXXXXXXXX--XXXXXXXXXXXXXXXX-XXXXXXXXXXXXXXX-XX-XXXXXXXXXXXXX-XXXXXXXXXXXXXXX-XXXX-XXXXXX-XXXX-XXXXXXXXXXXXXXXXXXXXXXXXXXXXXXXXXXXXX-XXXXXXFX
X-XXXXXXXXXXXXXXXXXXXXXXXXXXXXXXXXXXXXXXXXXXXXX-XXXXXXXXXXX-XXXXXXXXX--XXXXXXXXXXXXXXXX-XXXXXXXXXXXXXXX-XX-XXXXXXXXXXXXX-XXXXXXXXXXXXXXX-XXXX-XXXXXX-XXXX-XXXXXXXXXXXXXXXXXXXXXXXXXXXXXXXXXXXXX-XXXXXXXX