--------------------------------------------1---------------------------------------------------------------------------------------------------------------------------------------1--------2----------
----------------2----------------------------C----------------------------------------------------------------------------------------------------------------------------------------------------------
--------------------------1-----------------K-2-o---------------------------------1--------------------------------------------------------------------------------------@-----------11-----------------
--------------------------------b1-----------1----------------------------------------------------------------------------------------------------------------------------------------------------------
-----------------%2o---------C--L---1-----------K---b-------T-------------1-@-------------o------------------------o-----------------------------------------o--L----------1--------Q-------------------
--------------------------------G------------%------@-------------------o--------%------------------------o---------------------------------------------------------------%-----------------------------
----------------@----1--1@------G11-222-1FtU|B-1SC@CoCSB21---11------1----11----1-11---------------------1------------------------------------------------------1-@B2BB1112221--11@211B2B@1-------------
---------o------C---------------E-----o---2111--F---1---------1----------------o1---------------------------------------------------------------1-o-----------------------------1-----------------------
-M------------------------------1-------------------------------------------------------------------------------------------------------------o---------------------------------1-----------------------
--------------------------------1----11--11-----1--------1-----------------------o----------------------------------------------------------------------------------------------------------------------
----------------------------1oto-----1--11-o-----------------1--------o---------------------------------------------------------------------------o---------------------------o-------------------------
--2-------1%%%--@-----------%||%C-----1-----11------------------F1B-------------#-------------1%-----------------------o-----------------------------------1-----1--------------1-1------11---1--------1
--#%-----%G|||1B------------1||%B----------%E-------1-----------%%#-----------%%|-%-----------MX-------%-%---------------%---------%2%%------2-1--%%%%-%-%%%%---%%%%1-----------1--------%-%-%%--%---%%%
|-|KL-----U|||%|B-----------###%Q1--------1|||2---%##----------%|||-----------||||U-----------@Q-----1BB2-----%#t%-------%%-#%-%---%###%-----##%G-oQ|---Kt|||---||||%--------------------|||1|||#-%%M|||
X-XXXXXXXXXXXXXXX-XXX-XXXXX-XXXXXXXXXXXX-XXXXXXX-XXXXXXXXXX-XX-XXXXXXXXXXXX-XXXXXX-XXXXXXXXXX--XXXXXXXXXXXXXXXXXXXXXXX-XXXXXXXXX-XXX-XXXX-XXXXXXXXXXXX-XXXXXXXXXXXXX--XXXXXXXXXXX--XX-XXXXXXXXXXXXXXX-FX
X-XXXXXXXXXXXXXXX-XXX-XXXXX-XXXXXXXXXXXX-XXXXXXX-XXXXXXXXXX-XX-XXXXXXXXXXXX-XXXXXX-XXXXXXXXXX--XXXXXXXXXXXXXXXXXXXXXXX-XXXXXXXXX-XXX-XXXX-XXXXXXXXXXXX-XXXXXXXXXXXXX--XXXXXXXXXXX--XX-XXXXXXXXXXXXXXX-XX