------------E---------------------2-------1----1----------------------------------------------------------------------1-------------1-------------------------------------------------------------------
--%----------------------------------%--------%---------------------------------------------------------------%-T-----%-2--C1--------%---%----%%--------------------------------%------------%-%--------
|----------|-o--M----2--2-------|----Go--L-|--o--------------------------------------------------Q--------1-----|12---------K----E---oL---o-otT---------------------------------t2----2-----------------
o------------%1-S----------1--------%---------------------------------------------------------------------------T-%-%---%-------S---%-%---%-%%------------------------------------%---------%-----------
----t2-|-EX---t------%--------C---|--Loo-b-t-|---------------------------------------------------2|UX2--X---------o--U---||---X---|---|----|---1----------------------------------oT-------GT-----------
--%%-%----%----%2----------------%----%------1------------------------------------------------------------------M%%---%--%#%----o%-1--11--%-------------------------------------1-----%--------%--------
b-CBbbtFBTooXbQ21---1-----11----|bottotXSb|C22@1--------------------------------1-1---1---------o-2@oGKBG@2B----t1B1CKCB|||Xt|X-|Lo||UtooKoQtB11-----------o--------------------C-1-BEB-@EB11@E1--------
B--------1111-------------------b-11---1111-------1-----------------------------1---------------E---11----------U-1------1------M--1--11-11-------------------------------------1-----------------------
1M--------1-1-------------------1---------------------------------------------------------------1---------------1-------1-------1%----------1--------------11-------------------------------------------
--------------------------------1--------------------------------------o-------------o-------1---------o--------1----1--%----------------------------------||%------------------------------------------
--------1----1-------------------------------11---------------------------------------1---------1----1-------G1------1-1XK---B@1-----1-----o--1------------||-------------------------------------------
@-------------------------------G-1-------------2------%%11#%--%-----------%#---2-----21--------F1----------%%2%1------B|t%-----C---------1----------------||%--%-----%%11B---------------------1-1-----
1----------------------------------------------------2G||X||||||----------2||t%-1-----2---------------------b|b---------|X%---1-------------------1--------|b---||#--L||#%t------------------%%%-------%
---------------%%----%#%%-------2--------------%-----@F||||||B||%-%%-%-%%%-||E%-%%%---%2|%------|-----------2-##--------K1------2--------@------###------1##---%||B---###2|%-----------------|||------2|
X-XXXXX-XXX-XXXXXXXX-XX---XX-XXXX-XX--XXXX--XXX-XXXX-XX-XXXXXX-XX-XXX--XXXX--XX-XXXXX-XXX-XXX--XXX-XXXXX-XXX-XXXXXXXXX--XXXXXXXX-XXXXXXX-XX-XXXXX-XXXXX-XXX-XXXX--XXXXXXXX-XX--XXXX-XXXXXXXXXXXX-XXXXXFX
X-XXXXX-XXX-XXXXXXXX-XX---XX-XXXX-XX--XXXX--XXX-XXXX-XX-XXXXXX-XX-XXX--XXXX--XX-XXXXX-XXX-XXX--XXX-XXXXX-XXX-XXXXXXXXX--XXXXXXXX-XXXXXXX-XX-XXXXX-XXXXX-XXX-XXXX--XXXXXXXX-XX--XXXX-XXXXXXXXXXXX-XXXXXXX