--------------------------------------------------------------------------------------------------------------------------------------------------------------------------------------------------------
---o----------------------------------------------------------------------------------------------------------------------------B---------------o-----M------%%-----------------------------------------
|------o------------------------------------------------------------------Q--------------------------1--------------------------------------------o--------2o-----------C-oo----------------------------
--------%------------------------------------------------------------------%%---------------------------------------------------@-------------------------------B---------------------------------------
t---@---|-------------------------------o-------------------o---|%t-G---------o------------------------o------------------------1%---------------%tbo-|-|B---S----1-------B-2---------------------------
o-------C---11----------o----------------------------------------%---------------------------------------------------o----------1----------------------1--------------%-o-%-----------------------------
t-2LtTEQtE@@1--------------------------------------o----1C1---o-t2BBBBbT|bSCXQ1-----------------1-------------------------------1---------------o1tCt|||tB1--1--E---1@BBM@1-@2--------------------------
U-11---11o--------------------------------------1---------------X-----111111----1--o-------------------------------------o------1---------------b121111111------@--------1------------------------------
1M--------------------------------------------------------------M---o-----------1----------------------------------o----------------------o---------------------1---------------------------------------
---------------------------------------------------------------o2------o----------------------------------------o--------------------o----------1---------o-------o--------------------------%%---------
-------o-----1--------------------------------------------------2-----o------11-----BB---------------------------------------------------1------1------------1-----------------------------%X||%--------
1-----------o---11C--------T@%1%---o------------#%%-------------|G%-------------1--1|C1-|X1--------1---11----------1--ME--------%%-%---------1-%%---------------1-------------1------------%U|t%%-1-%%%%
---------------2--%--------||X%1-%1-------------||1----------%%%|%----------------%B||%#||#1-------%%%%%%--------%%%%%%%%%%%----|||1---------%||||%--------------------------%-%-----------%K||%%-#1b|||
-------------1##tL|-------B||##%X1#----%#%%-----||#----------|||||#-------------1--@XG#%%@---------E|||||X2-----12||||t||||M%---|||K---------1b|||#------1-------------------1||---||@----%%%-%---||||||
X-XXXXXXXX--XXXX-XXXXXXXXXXXXXXXXXXXXXXXXXXXXXX-XXX-XXXXXXXXXXXXXXXXXX-XXXXXXXXXXXXXXXXXXXXXX-XXXX--XXXXXXXXXXXXXXXXXXXXXXXXXXXXXXXX--XXXXXXXXXXXXXXXXXXXXXXXXXX-XXXXXXXXXXXXXXXXXXXXXXX--XXXXXXX-XXXXFX
X-XXXXXXXX--XXXX-XXXXXXXXXXXXXXXXXXXXXXXXXXXXXX-XXX-XXXXXXXXXXXXXXXXXX-XXXXXXXXXXXXXXXXXXXXXX-XXXX--XXXXXXXXXXXXXXXXXXXXXXXXXXXXXXXX--XXXXXXXXXXXXXXXXXXXXXXXXXX-XXXXXXXXXXXXXXXXXXXXXXX--XXXXXXX-XXXXXX