-----------------------------------------------------------------------------------------------------------------------------------------------------------------------------------------1--------------
-------------------------------------1-o-----------------------------------------------------------------------------------------------------------------------------------------B----------------------
------------------------------------o-o--2-GC-----------------------------------1-----------------------------------------------11----------------------------------------------------M-----|-----------
----------------------------------------------@-----------------1---------------------------------------------------------------1---------------1-------------------------------o---%-%-----------------
--------------------------------|-2-C----1--@-K---------------------------------------------12----------------------------------------------------------------------------------|-|-|2b-||-B-||---------
-----------------------------------%%-----%-------------------------------------------------------------------------------------1-------------------------------------------------%%--------------------
---------12---------------------b@11@G1-2EL21B1---------------------------------1-----1--@---1----------------------------------1---o----------------1----1---------------------|to||||bt|U2FQE1--------
--------------------------------C-------------------------------11---------------------------------o----------------------------1-----------------------------------------------o112121111--------------
-M---------------------------------------------------------------------------------------------------------------------------------------------------------o--------------------@%--1---1---------------
--------------------------------1-------------------------------1--------------------------------------B%-----------------------1-------------------------%---------------------------------------------
------------------------------o------2--------1Q-----------------------------------------------------%||%---------------------------1--------------------%||%------------------------1---1---122--------
----------------tS%---%%----------------------2o----1-B%---%-----------11111----F1B--1--B------------#||#--||-------------------1-1-o2-1------------o----%|%#------1------------Q-1---------------------
---------%%##%--||#--%|||%------------------------%2|o|||||||||S-------%%##%%-----%--%%%%------------%||#-%||---%%%--%-%%%-------%%%%%%%%----------------t||@-1-%%%%------------1-------------1C--------
---------|||||%-#%#--%#%-------------%%-------@---%Ctt|t||||EB-K----%%-C|||||---X-|-1|||U----------%%-%-%-#-1---o||%-1||2%%%%%-%SC|||||||-------%-------1||@#%%-|||||---------%#2-----------------------
X----XX-XXXX--XXX--XXXXXXX--XX-XXXX-XXXX-XXXXXXX-XX-XXXXX-XXXXXX--XXXX--XXXXXXX-XX-XXX--XXXXXXXXX--XXXXXXX---XXXX-XXXXXXXX--XXXXXXXX-XXXXXXX-XXXXXXXX---XXX--XX-XXXX--XX--XX--XXXXXXXXXXXXX-XXXX-XX--XFX
X----XX-XXXX--XXX--XXXXXXX--XX-XXXX-XXXX-XXXXXXX-XX-XXXXX-XXXXXX--XXXX--XXXXXXX-XX-XXX--XXXXXXXXX--XXXXXXX---XXXX-XXXXXXXX--XXXXXXXX-XXXXXXX-XXXXXXXX---XXX--XX-XXXX--XX--XX--XXXXXXXXXXXXX-XXXX-XX--XXX