--------------------------------------------------------------------------------------------------------------------------------------------------------------------------------------------------------
-----------------------------------------------------%---%%-----E----%----------------------------------------------------------1------------------------------------------------%--------%-----1-------
----------------------------------------------------C-----------o-------2--------------------1--1-------------------------------1------------------------------------------------@1-E--1X-2-----1-------
--------------------------------------------------------------1---------------2-1------------------------------------------------------------------------------------------------%------------1-E-------
--------------------------------------------------1-------F--E----------------K--------------------------------------------------------------------o----------------------------o--F------BLo-----------
--------------------------------1----------------%------%-%%--%-----------------1-----------------------------------------------1-----------------------------------------------%-%-%-----%-------------
--------------------------------1---------------F211121-@t|111--C---E1---11-----1-----------------------------------------------11----------------------------------------------UFCETC1--1C11-11----11--
--------------------------------1---------------1--------1------1---------------1---------------2-------------------------------------------------------------------------------1--1------------2-------
-M------------------------------------------------o-----------------------------------------------------------------------------------------------------------------------------------------------------
--------------------------------1----------2@----o-----------------------------%------------------------------------------------------------------------------------------------------------------------
-------------------------------------------@@-----------------------o---------XM--------o---------------------1-----------------------------------------------------------------------------------------
---#1%---------------%--%---%------o1------bt-1-----------1------------------%|F112---2111--------------------------------------2--1---1--1-----%%11-%-2%#%%---------------%----1-------------1---------
--1||||%1----1--%-%%||||||b@F1%----------%-##%%----------%%%-%---------------@tE--%---%#%%------%%1----------------%%%#%%%%-----%%-%%%%%%%------|||#||#%||||#------------%|K%---%%%-----------%%--------
1-%F%#%------2-%--2X|||||t%-|||U----------t||tT%------1|C|||||%------------%#%#%1-o---||||S-1---t-#%1-----------%--||||||||-----|12||Q|||2t-----t||-||-%X||E1---b---K21---%##--%||t-----------||--------
X-XXXXXXXXXXX--XX-XX-XXXXX-XXXXXXXXX-XXXXX--XX---XXXX--XX-XX-XXX--XX---XXXX-XXXX-XXXXXX-XX-XX-XX-XX--XXX-XXX-XX-XX--XX---XX--XXXX---XXX-XX--XXXXX-XXXXXXXX-XXXX--XXXXXX-XX--XXXXXXX--XXXXXXX-XXXX-XX-XFX
X-XXXXXXXXXXX--XX-XX-XXXXX-XXXXXXXXX-XXXXX--XX---XXXX--XX-XX-XXX--XX---XXXX-XXXX-XXXXXX-XX-XX-XX-XX--XXX-XXX-XX-XX--XX---XX--XXXX---XXX-XX--XXXXX-XXXXXXXX-XXXX--XXXXXX-XX--XXXXXXX--XXXXXXX-XXXX-XX-XXX