--------------------------------------------------------------------------------------------------------------------------------------------------------------------------------------------------------
--------------------------------------------------------------------------------------------------------------------------------------------------------------------------------------------------------
-----------------------------1-------------------------------------o-K-2--------------------------1----------|------------------------------------------------------------------------------------------
------------------------%-------------------------------------------------------G---------------------%-------------------------------------------------------------------------------------------------
-----------------o---------1----------------------------------o---o-|-------Mo-----------o-o-------b----o------------o------------------------o--%-----------1-----------------------o------------------
----------oo------%----------------o------------------------------%-------------B-------------------------%-------------------------------------------@----------------------------o--------------------
----------------K1--112111111-----------o----o------------------|TGCt|tQQBB121-oB----1---2-o----|M@1|UMBotQC@2C@----o11--------------------o-------1--2-11---------o-----------o1--------1---1----------
----------------@--------------o----------------o---------------L--1-1----------1---------------t1111111121-------------------------------o-----2----------o----------------o---@------------------o----
-M-----------o-----------------o------------------------o-------------------------o--------o----C%------------o----------o----------------------------------------------------------o-------------------
----------------------------------------o-------o---o-------o----------------1------------------2----1--------1-----------------------Gt----------------------------------------B-----------------------
------o--------o---------------oo----------------------------------------1---2------------------1---11--o1---22-----------------------St%----------------1---------------------------1------------------
2----------%%%%%1------o--o-----%1%1-------o---o--------%-1---1-@--------Ut-------1---o---------M---------1-----G-1----o-------%--1-1-Xt%-------11-----o------------------------E-C-1-------------------
----------1|||||--%%%%----------###%--------%2B--------KKB%---%%1--------||-----1---------------1-------------1------------%%##%-%%%%%%%%%--------------1--------%-----%-%%%%----%#--------------------%
----------%oo2%---||||#---------|||||----211-L@%%-----t||M||||||1--------||%----%%#%------------B---------------------1|%-%1||||-1|o|||||-----1%@------%#%%--1%#G%#%---1X@||||GX%#-#1------------------|
X-XXXXXXXXXXXXXXXXXXXXXX-XXXXX-XXXXXX-XXXXXXXXXXXXXXXXXXXXXXXXXXXX-XXXXXXXXXXXXXXX-XXXXXXXXXXXXXXXXXXXXXXXXXXXXXXXXXXXXXXXXX-XXXXXXXXXXXXXXXXXXXXXXXXXXXXXXXXXXXXXXXXXXXXXXX-XXXXXXXXXXXXXXXXXXXXXXX--FX
X-XXXXXXXXXXXXXXXXXXXXXX-XXXXX-XXXXXX-XXXXXXXXXXXXXXXXXXXXXXXXXXXX-XXXXXXXXXXXXXXX-XXXXXXXXXXXXXXXXXXXXXXXXXXXXXXXXXXXXXXXXX-XXXXXXXXXXXXXXXXXXXXXXXXXXXXXXXXXXXXXXXXXXXXXXX-XXXXXXXXXXXXXXXXXXXXXXX--XX