--------------------------------------------------------------------------------------------------------------------------------------------------------------------------------------------------------
---------------------------------------------------------------------------------------------------------------------------------------------------------------%-----@---------------%---%%-------------
---------------------------------------------------------------------------------------------------------------------------------2-----------------o------------------G------------------E-K------------
----------------------------------------------------------------1--------------------------------------------------------------------------------------1--------|---%---------1-C-------------2---------
-------o-------------------------------------------------------------------o--------------------o------------------------------o-%------@1-------F--o---b---b-------o------2-t----------M----M--o-------
-------------------------o------------------------o--------------------------o-------------------------------------o------------1-----------------%-------------o%------o-%----%------------------------
--------------o------------o-------------o---------------------o-------------------------------------------------------o----------1GQ@-111-oo---|tS2GtULKQC2CFG1|12GSK@1@EMGXCEE2---221-11@@21-----o----
------------------------------------o---------------------------------------------o----------o----------------------------------1---------------S1---1-1-1--o---t----------1----C------------------o----
-M--o---------------o-------o-------------------------------------------------------------------------------------------------------o--o--------1----------------%--------------------------------------
-------o--------o-----o-----------------------------o------------------------------------------------------------------------o------------o---o-2o--------------1----1-------1--------------------o-----
---------------@------------------------------------------------------------------------------------o--------------------------------------------1---1--o------------1------------------------1---------
-----------------------------------o---o--------%%----------2--------------------11----------1-%------------2---o---------@-%%1-------------o---11F-----o-------Eo-o------------Q2--------------#1%-----
#-#--------%%-#%-----%%%%%%##%%--%1%---%%%-----%@|G%-%%----@1-------------------------1------%||------------t---%-------1|||||tB-------------%--1------------%------------------|%--------------|B||#%--
|-|E%-----Q|||||-----||||t||||b-#%#||-%|||%---||KX#%%%%%%%%%#------------%%%#-%%-----1#-|----2||%%#%1---%%%@|S--t-------%-@%-1%%-----------2###%-1|2-------F||%-|---------------|1#-------------||||||#-
X-XXXXXXXXXX--XXXXXXXXXXXXXXXXXXXXXXXXXXXXXXXXXXXXXX-XXXXXXXXXXXXXXXXXXXXXXXXXXXXXXXXXXX-XXXXXXXXXXXXXXXXXXXXXXXXXXXXXXXXXXX-XXXXXXXXXXXXXXXXXXXXXXXXXX-XXXXXXXXX-XXXXXXXXXXXXXXXXX-XXXXXXXXXXXXXXXXX-FX
X-XXXXXXXXXX--XXXXXXXXXXXXXXXXXXXXXXXXXXXXXXXXXXXXXX-XXXXXXXXXXXXXXXXXXXXXXXXXXXXXXXXXXX-XXXXXXXXXXXXXXXXXXXXXXXXXXXXXXXXXXX-XXXXXXXXXXXXXXXXXXXXXXXXXX-XXXXXXXXX-XXXXXXXXXXXXXXXXX-XXXXXXXXXXXXXXXXX-XX